....rr..rr....
.....rrrr.....
....rrrrrr....
...rr.rr.rr...
...rrrrrrrr...
....rr..rr....
...rr....rr...
..rr......rr..
