..............
..rr......rr..
..oo......oo..
..yy......yy..
..............
..gg......gg..
..cc......cc..
..bb......bb..
