..............
..............
r.r.r.r.r.r.r.
.o.o.o.o.o.o.o
y.y.y.y.y.y.y.
.g.g.g.g.g.g.g
c.c.c.c.c.c.c.
.b.b.b.b.b.b.b
