r............r
.o..........o.
..y........y..
...g......g...
....c....c....
.....b..b.....
......pp......
......ss......
